#1

01111111111000000000
02222200000000000000
01111111111000022220

00000022222000000000
00000000000000000000
02222211111000200000

00000000000400000000
00000000000000000000
00000022222002000000

00000000000000000000
00000000000000000000
00000000000420000000

#2

01111111111000000000
02222200000000000000
01111111111000022220

00000022222000000000
00000000000000000000
02222211111000200000

00000000000400000000
00000000000000000000
00000022222002000000

00000000000000000000
00000000000000000000
00000000000420000000

#3
01111111111000000000
02222200000000000000
01111111111000022220

00000022222000000000
00000000000000000000
02222211111000200000

00000000000400000000
00000000000000000000
00000022222002000000

00000000000000000000
00000000000000000000
00000000000420000000

#4
01111111111000000000
02222200000000000000
01111111111000022220

00000022222000000000
00000000000000000000
02222211111000200000

00000000000400000000
00000000000000000000
00000022222002000000

00000000000000000000
00000000000000000000
00000000000420000000

#5
01111111111000000000
02222200000000000000
01111111111000022220

00000022222000000000
00000000000000000000
02222211111000200000

00000000000400000000
00000000000000000000
00000022222002000000

00000000000000000000
00000000000000000000
00000000000420000000
