#0 => EMPTY
#1 => CUBE
#2 => COIN
#3 => GEM_SCORE
#4 => GEM_SPEED

#Blocks Count
#at least 2 => 1 for initialization and 1 for generation
5

#1	=> initial block

00000000001111111110
00000000002222200000
00000000001111111110

00000000000000002220
00000000000000000000
00000000000222221110

00000000000000000000
00000000000000000000
00000000000000002220

00000000000000000000
00000000000000000000
00000000000000000000

#2

01111111111000201110
02223200000000001110
01111111111000022220

00000022222002000030
00000000000000002220
02222211111000200000

00000000000220000000
00000000000000000000
00000022222002000000

00000000000000000000
00000000000000000000
00000000000320000000

#3

01111111100111110020
01111111100020000000
01111111102000000000

02221111100111110030
02221111100200000000
02222222220000000000

00002222200000002200
00000111102000000000
00000000003000000000

00000000000000000000
00000222230000000000
00000000000000000000

#4

01111111102222223110
01111102220111102220
02002220111111111110

01111111100000000110
01111100000111100000
00220030111111111110

01111111100000000110
01111100000111100000
00000000111111111110

01111111100000000110
01111100000111100000
00000000111111111110

#5

0111111110000111110
0111111110000111000
0111111110000200210

0231111110000111110
0221111110000111020
0221111110000022310

0002211110000111110
0002311110000111000
0002211110000000010

0000000000000111110
0000000000000111000
0000022220000111110
