#1

00000000001111111110
00000000002222200000
00000000001111111110

00000000000000002220
00000000000000000000
00000000000222221110

00000000000000000000
00000000000000000000
00000000000000002220

00000000000000000000
00000000000000000000
00000000000000000000

#2

01111111111000201110
02222200000000001110
01111111111000022220

00000022222002000000
00000000000000002220
02222211111000200000

00000000000220000000
00000000000000000000
00000022222002000000

00000000000000000000
00000000000000000000
00000000000220000000

#3

01111111100111110020
01111111100020000000
01111111102000000000

02221111100111110000
02221111100200000000
02222222220000000000

00002222200000002200
00000111102000000000
00000000000000000000

00000000000000000000
00000222220000000000
00000000000000000000

#4

00000000000000000000
00000000000000000000
00000000000000000000

00000000000000000000
00000000000000000000
00000000000000000000

00000000000000000000
00000000000000000000
00000000000000000000

00000000000000000000
00000000000000000000
00000000000000000000

#5

00000000000000000000
00000000000000000000
00000000000000000000

00000000000000000000
00000000000000000000
00000000000000000000

00000000000000000000
00000000000000000000
00000000000000000000

00000000000000000000
00000000000000000000
00000000000000000000
