#0 => EMPTY
#1 => CUBE
#2 => COIN
#3 => GEM_SCORE
#4 => GEM_SPEED
#5-6 => GEM_CRAZY

#Blocks Count
#at least 2 => 1 for initialization and 1 for generation
13

#1	=> initial block

00000000001111111110
00000000002222200000
00000000001111111110

00000000000000002220
00000000000000000000
00000000000222221110

00000000000000000000
00000000000000000000
00000000000000002220

00000000000000000000
00000000000000000000
00000000000000000000


#2

01111111111000201110
02223200000000001110
01111111111000042220

00000022452002000030
00000000000000002520
02222211111000200000

00000000000220000000
00000000000000000000
00000022522005000000

00000000000000000000
00000000000000000000
00000000000320000000

#3

01111111100111110020
01111111100020000000
01111111102000000000

02521111100111110030
02521111100500000000
02222254220000000000

00002242500000005200
00000111102000000000
00000000003000000000

00000000000000000000
00000252230000000000
00000000000000000000

#4

01111111102252223110
01111102520111102520
02002520111111111110

01111111100000000110
01111100000111100000
00240030111111111110

01111111100000000110
01111100000111100000
00000000111111111110

01111111100000000110
01111100000111100000
00000000111111111110

#5

0111111111110111110
0111111111110111000
0111111111110400210

0231111111000111110
0251111111000111020
0241111111000052310

0002211122000111110
0002311124000111000
0002211123000000010

0000025200000111110
0000023200000111000
0000025220000111110


#6

0111111111111111110
0111111111111111110
0111111111111111110

0221100004222112200
0240001110011222110
0231110011252511110


0001152220000110000
0000001110011000110
0001110011000011110

0001100000000110000
0000001110011000110
0001110011000011110

#7

0111111111111111110
0111111111111111110
0111111111111111110

0221100004222111220
0240001110012512510
0231110011110242110


0001122520000111000
0000001110010010010
0001110011100000110

0001100000000111000
0000001110010010010
0001110011100000110

#8

0111111111111111110
0111111111111111110
0111111111111111110

0003011111001110000
0252524222111111100
0004011111111111110

0000011111001110000
0000000000235111100
0000000111111111110

0000011111001110000
0000000000000000000
0000000243111111110


#9

0110111111110000000
0110111111110000000
0110111111110000000

0110000011010111110
0000011111110111110
0110011111111011110

0000000011101145110
0000000011002222110
0000011111101111110

0000000211100022220
0000022211100022220
0000022211100002220

#10

0110111111110000000
0110111111110000000
0110111111110000000

0110000011010111110
0000011111110111110
0110011111111011110

0000000011101145110
0000000011002222110
0000011111101111110

0000000211100022220
0000022211100022220
0000022211100002220

#11

0111111111100111110
0011111111111111110
0111111111111111110

0111111111100111110
0001110011111100110
0111111110011111110

0111111111100111110
0000110011111100110
0111111110011111110

0111111111100111110
0000010011111100110
0111111110011111110

#12

0111111111111111110
0001111111111111110
0111111111111111110

0111111111111110010
0000011111110011110
0111111111111110010

0111111111111110010
0000000111110011110
0111111111111110010

0111111111111110010
0000000001110011110
0111111111111110010

#13


0111111111111111110
0111000111000111000
0111111111111111110

0111111111111111110
0000000000000000000
0111111111111111110

0111111111111111110
0000000000000000000
0111111111111111110

0111111111111111110
0000000000000000000
0111111111111111110
